454545454545454545454545
454248424542484245424842
454845454545454845484545
454245424842454245424842
454545454548454545484545
454248424542454248424842
454845454545454845454545
454245424542454245424842
454845484548454545484545
454248424542484245424842
454545454545454545484545
454248424542454245424542
